X#X########XX#XXXXX#
#XX####...XX###X.XXX
X#XX#XX.#....#...##X
X#XX#XX...#..#.#...#
#...XX###.##...###.X
X.#..X.#.#XXX#.....X
#.#X.X..##XXX####X.X
X.XXXX.X##XXX.X.XXX#
#.XXXXX.XX...XXXXXXX
#..XXX.XXXX..XXX##..
##..#...XX....XX#..#
#..#..#.XX.#..#XX..#
#.#..#...X..#..XX.##
#.#.XX....#..#..#..#
#.#.XXX.#..#..#..#.#
#.#..XX#..#.#..#.#.#
#..#..XX.#...#.#...#
X#.##.X#.#.#...XX..X
XX.....#....XX#XX.X#
X###########XXXXXXXX
