###.#######
##..#.....#
#..#..###.#
#.#..#....#
#.#.#..####
#...#.#...#
####..#.#.#
#....#..#.#
#.###..##.#
#.....#...#
###########
